111111111111111
1P0000000000011
101111011110101
100001C00000001
101011111110101
1C0000000000C01
101011101110101
100000C00000E1
111111111111111
