1111111111111111111
1P0000000C000000011
1011110111100000101
100001C000000000001
1010111111101010011
1C0000000C000000C01
1010111011100000101
100000C0000000000E1
1111111111111111111